Participant ID ,Qualtrics ID,Duration (min),PK OR ,PK Self-Rating,PK Terms,PK Total,Intrinsic Load,Extraneous Load,Germane Load,Retention OR1,Retention OR2,Retention OR3,OR Retention Total,MC Retention,Retention Total,Transfer OR1,Transfer OR2,Transfer OR3,Transfer OR Total,Transfer MC,Transfer Total,Delay,Relevancy,Animated?,Fluent,Native
1,R_2irjXAQf2viDMeR,15.25,0,1,0,1,3,3,2.333333333,0,0,0,0,6,6,0,0,0,0,0,0,Immediate,Irrelevant,Static,2,2
2,R_VOnumFfZmKnb3kB,18.26666667,0,1,1,2,2,4,4.666666667,2,1,1,4,10,14,0,1,0,1,2,3,Delayed,Relevant,Static,1,1
3,R_2QZ0KhlU3C08IEj,19.16666667,0,3,3,6,9,10,8,4,0,0,4,7,11,0,1,1,2,1,3,Delayed,Irrelevant,Animation,1,1
4,R_T1V98LugcbBgkrn,20.01666667,1,2,5,8,4.333333333,8.75,5,2,3,1,6,11,17,1,2,0,3,2,5,Delayed,Irrelevant,Static,1,2
5,R_Z2ExFpzVyUjYIyB,20.11666667,0,1,7,8,5,6.75,8,4,4,2,10,13,23,1,1,1,3,1,4,Immediate,Relevant,Animation,1,1
6,R_1LCgoW8vUIRUu89,18.63333333,1,2,4,7,3.666666667,5.75,6,3,2,2,7,11,18,1,1,1,3,2,5,Immediate,Irrelevant,Animation,1,1
7,R_1rCbOYtURgwr1RX,23.98333333,2,3,10,15,6.333333333,6.75,6.666666667,3,8,2,13,12,25,2,1,1,4,3,7,Delayed,Relevant,Static,1,1
8,R_2TpbqpxNK9ulyZn,89.26666667,0,1,3,4,2.333333333,5.5,6.666666667,2,0,2,4,12,16,1,1,1,3,1,4,Immediate,Irrelevant,Animation,1,2
9,R_3MsrZvptu9f0YJx,23.26666667,1,1,0,2,0,6,1.666666667,4,3,0,7,12,19,1,2,1,4,2,6,Delayed,Relevant,Animation,1,1
10,R_2E04Scw1OqaGrtZ,12.78333333,0,1,0,1,1.333333333,3.5,3.666666667,3,0,0,3,5,8,1,1,0,2,3,5,Immediate,Irrelevant,Static,1,2
11,R_2Wx0Fis0M9sixeq,14.53333333,0,2,7,9,7,9,4.666666667,4,1,2,7,12,19,0,1,0,1,1,2,Delayed,Relevant,Static,1,1
12,R_1PUghbXzLaW6QpL,20.75,0,1,0,1,5.666666667,6.25,6,3,0,2,5,8,13,1,0,1,2,1,3,Delayed,Irrelevant,Animation,1,1
13,R_1i35zExRNDpWTjF,15,0,3,1,4,2,8.25,4.666666667,1,0,0,1,6,7,1,1,1,3,2,5,Immediate,Relevant,Static,1,2
14,R_1rq1xCFlSw0frrR,17.26666667,0,1,6,7,8,9.5,6.333333333,5,3,1,9,8,17,1,2,1,4,1,5,Immediate,Relevant,Animation,1,1
15,R_1hXQMP7BsUYk23M,18.63333333,1,3,9,13,8,9.25,9,3,5,2,10,8,18,1,0,1,2,1,3,Immediate,Irrelevant,Static,1,2
16,R_PA3WjwQivEHbMmR,24.11666667,1,1,0,2,3.666666667,7.5,7,3,0,0,3,6,9,0,1,0,1,2,3,Delayed,Relevant,Animation,1,1
17,R_3e2MibffLyP0CKh,21.7,0,1,4,5,4.666666667,7.25,5.666666667,4,1,0,5,5,10,1,1,0,2,1,3,Delayed,Relevant,Static,1,1
18,R_1JLodTYXQDR7F9V,19.86666667,1,1,0,2,4.333333333,4.75,5.666666667,3,0,0,3,9,12,1,2,0,3,3,6,Delayed,Irrelevant,Static,1,2
19,R_3CT4yOpAUKhiuQB,15.03333333,0,3,1,4,5.333333333,10,8.333333333,1,1,0,2,8,10,1,0,1,2,2,4,Immediate,Irrelevant,Animation,1,1
20,R_Oxrse9lpHYpx20h,20.68333333,1,1,1,3,9,10,10,2,1,0,3,9,12,1,0,0,1,2,3,Immediate,Relevant,Static,1,1
21,R_3EE8YSEWHDhj8nA,25.06666667,1,1,6,8,6,6.25,5.666666667,4,1,1,6,6,12,0,0,0,0,1,1,Delayed,Irrelevant,Static,1,2
22,R_2q96SK7YhErQorK,12.78333333,0,1,3,4,6,9,6.333333333,2,0,1,3,4,7,0,0,1,1,2,3,Delayed,Irrelevant,Animation,1,1
23,R_3iU8KWuG2VIySsr,20.18333333,1,1,9,11,7.666666667,10,9,3,2,2,7,8,15,1,1,1,3,1,4,Immediate,Relevant,Animation,1,1
24,R_1BUXptzoBDNZT1F,16.35,0,1,3,4,4.666666667,8,5,3,0,0,3,8,11,2,2,0,4,0,4,Delayed,Relevant,Static,1,2
25,R_1LC0QSTbLID7ntL,2672.183333,0,1,0,1,5.333333333,7,8.333333333,2,0,1,3,5,8,0,1,0,1,2,3,Immediate,Relevant,Animation,1,2
26,R_3mW9h21jrFq3FgR,16.61666667,0,3,0,3,7.666666667,9.25,4.666666667,2,0,1,3,7,10,2,1,1,4,3,7,Delayed,Irrelevant,Static,1,1
27,R_6GvdvgU5hCxQACJ,19.95,0,3,4,7,6,7.25,8.666666667,2,0,0,2,7,9,1,1,0,2,1,3,Immediate,Irrelevant,Animation,1,1
28,R_1KllJXROJ8j95M8,23.03333333,3,3,4,10,3.666666667,6,6.666666667,2,3,2,7,13,20,1,1,0,2,3,5,Immediate,Relevant,Static,1,1
29,R_2WTE1dyvXaSVXzo,32.13333333,0,1,5,6,1.333333333,6,4,2,0,1,3,6,9,0,1,0,1,1,2,Delayed,Irrelevant,Animation,1,2
30,R_1GJ3J2TqdYHz3Vl,18.56666667,1,2,6,9,3,4.5,6.666666667,4,2,2,8,13,21,1,1,0,2,2,4,Immediate,Irrelevant,Static,1,2
31,R_2WMAtNQNUhczLkU,19.95,1,1,2,4,4,7.5,8.333333333,3,1,4,8,13,21,1,1,0,2,1,3,Delayed,Irrelevant,Static,1,1
32,R_11hF4fW5Yy8E6KV,19.96666667,0,1,4,5,2.666666667,9.25,8,4,0,2,6,10,16,1,1,0,2,2,4,Immediate,Relevant,Animation,1,1
33,R_2dopivNSGxdbUmP,20.85,0,2,4,6,8.666666667,9.5,8.666666667,3,1,2,6,11,17,0,1,1,2,2,4,Delayed,Relevant,Static,1,1
34,R_2wBKpGKjhvBdy93,19.9,0,1,3,4,6,7.25,7.333333333,2,3,3,8,9,17,2,1,0,3,1,4,Immediate,Relevant,Static,1,1
35,R_BPy0G3EYOykrHxf,24.96666667,1,2,4,7,7,9.25,9.333333333,5,0,3,8,14,22,1,1,1,3,2,5,Delayed,Irrelevant,Animation,1,1
36,R_XYgs47sGFqpIG2d,24.98333333,0,2,7,9,4,6,4,3,0,3,6,11,17,1,2,0,3,0,3,Delayed,Irrelevant,Static,1,2
37,R_8et4gyH1n2irI5P,25.25,0,1,8,9,7.666666667,7.75,6,4,0,0,4,11,15,0,2,0,2,1,3,Immediate,Relevant,Animation,1,2
38,R_3fdzv3ghyr7MtgO,20.56666667,1,1,7,9,6,7.75,7.666666667,4,0,1,5,9,14,1,1,1,3,2,5,Immediate,Irrelevant,Animation,1,2
39,R_1MRsIWJNjDHB97u,21.11666667,0,4,6,10,8,8.75,6.666666667,3,0,0,3,5,8,2,2,0,4,2,6,Delayed,Relevant,Animation,1,2
40,R_3pa2bkwkrrE0IMw,31.48333333,1,3,10,14,7.333333333,9,8.333333333,5,4,1,10,12,22,1,1,0,2,2,4,Delayed,Irrelevant,Animation,1,1
41,R_1Q4P0vJg32G12Yj,18.28333333,0,1,1,2,7.666666667,9,5,3,3,0,6,10,16,2,1,0,3,2,5,Immediate,Relevant,Animation,1,1
42,R_2BlnOTTOM8XV5DA,23.68333333,1,2,8,11,7.333333333,6.75,7.666666667,3,0,3,6,7,13,1,2,1,4,2,6,Delayed,Irrelevant,Static,1,2
43,R_2bJpejkJpmXA0D3,14.53333333,0,1,5,6,6.666666667,9,7.666666667,2,0,3,5,7,12,2,1,1,4,2,6,Immediate,Irrelevant,Static,1,1
44,R_6YfJJyt8yUYv2JH,22.35,1,1,12,14,7.333333333,8.75,6,5,3,2,10,9,19,1,1,0,2,2,4,Delayed,Relevant,Animation,1,2
45,R_2V2t4RD6fHhKUze,19.31666667,1,1,1,3,6,8.25,5,4,0,0,4,7,11,0,0,1,1,0,1,Immediate,Irrelevant,Animation,1,1
46,R_22WFb0uaNxx99IU,20.65,1,3,6,10,5,7.5,8.666666667,4,4,3,11,11,22,2,1,0,3,3,6,Immediate,Relevant,Static,1,1
47,R_ONWnjronxfYJ1pn,20.6,0,1,7,8,5.333333333,7.25,4.333333333,2,2,0,4,6,10,1,2,1,4,1,5,Delayed,Relevant,Static,1,1
48,R_1hMS8CcRDyS3ZFK,22.28333333,1,1,2,4,7.333333333,8.5,3,2,0,0,2,9,11,0,1,1,2,2,4,Delayed,Relevant,Animation,1,2
49,R_8iUeqG1Qnjznv4l,22.01666667,1,2,4,7,7,9,7,5,1,0,6,10,16,1,1,0,2,2,4,Immediate,Irrelevant,Animation,1,2
50,R_32W37VkcAh3tnII,23.31666667,0,2,9,11,4.666666667,7,8,4,2,3,9,10,19,1,0,1,2,3,5,Delayed,Irrelevant,Static,1,1
51,R_3HGF3WLM5Zz2DN5,16.36666667,1,1,2,4,2.333333333,3.75,7.333333333,2,0,2,4,12,16,1,1,0,2,2,4,Immediate,Irrelevant,Animation,1,1
52,R_Z33XNrf8tbtarLP,25.03333333,0,2,0,2,3.666666667,6.25,7.333333333,1,0,1,2,11,13,2,1,0,3,3,6,Delayed,Irrelevant,Static,1,2
53,R_2cpaxyXA62U5ElP,25.46666667,0,3,0,3,6,7.25,4,4,1,0,5,4,9,1,0,0,1,1,2,Immediate,Relevant,Static,1,1
54,R_3JbiyD3mgQJwkKN,17.95,2,1,1,4,6.333333333,8,7.333333333,0,0,2,2,7,9,1,1,1,3,2,5,Delayed,Irrelevant,Animation,1,2
55,R_3JmU31L2ZwJrYDW,19.51666667,1,3,10,14,3.666666667,9,8.333333333,4,1,2,7,11,18,1,1,0,2,3,5,Delayed,Relevant,Animation,1,1
56,R_2ANedMnWsT0Hcp7,20.5,1,3,4,8,3.666666667,9,5,3,0,0,3,9,12,2,1,1,4,2,6,Immediate,Relevant,Static,1,1
57,R_21pjHvLeB3WHR4h,23.11666667,1,1,2,4,2,7.5,2.666666667,2,1,0,3,8,11,0,1,0,1,1,2,Immediate,Irrelevant,Static,1,1
58,R_31cnFFB4SUGYveU,47.45,0,1,5,6,8,8.5,6.666666667,4,0,1,5,9,14,1,1,1,3,2,5,Immediate,Relevant,Static,1,2
59,R_ONZw4HhvT1HHpPH,31.96666667,0,2,1,3,7.666666667,8.5,5,4,1,2,7,10,17,1,0,0,1,2,3,Delayed,Irrelevant,Animation,1,2
60,R_eqVJW6o5rzdEe77,46.81666667,0,1,5,6,5,5.75,6.666666667,4,2,4,10,12,22,2,1,0,3,2,5,Delayed,Irrelevant,Static,1,1
61,R_10raPbd4fouT9K7,21.18333333,2,4,12,18,3.333333333,5.75,6.333333333,5,6,3,14,10,24,1,1,1,3,3,6,Delayed,Irrelevant,Static,1,1
62,R_3073PAnmzOqzxDo,28.13333333,2,2,8,12,4.666666667,7,5.333333333,5,5,3,13,13,26,2,1,0,3,1,4,Immediate,Relevant,Animation,1,1
63,R_1Qi8KRTgvSmusYx,26.05,2,1,5,8,5.666666667,8.5,6.333333333,4,3,2,9,12,21,1,1,1,3,1,4,Immediate,Relevant,Animation,1,1
64,R_3lMHDXm7iXbddm9,16.15,0,1,3,4,6.666666667,8.25,6.333333333,3,0,0,3,5,8,2,1,0,3,2,5,Delayed,Relevant,Static,1,2
65,R_2eQGE4rOsAyyEAK,17.85,0,1,2,3,3,9,9.333333333,3,0,1,4,6,10,2,1,1,4,2,6,Immediate,Irrelevant,Animation,1,1
66,R_241qLxD6L5cXTsM,20.28333333,1,2,6,9,7.333333333,7.75,6.666666667,3,0,2,5,11,16,1,2,1,4,2,6,Immediate,Irrelevant,Animation,1,1
67,R_3DhjuTsSTL3AQSV,16.75,0,1,8,9,5.333333333,9.5,7,2,0,0,2,9,11,1,2,1,4,1,5,Delayed,Irrelevant,Static,1,2
68,R_3n0Pt1iWHwMhtQt,23.43333333,0,1,4,5,4,7.5,5.666666667,1,0,1,2,5,7,0,1,0,1,2,3,Delayed,Relevant,Static,1,2
69,R_3erF9LcJO4CwaLn,11.46666667,1,2,2,5,2.333333333,5.5,5.333333333,2,0,0,2,7,9,1,1,0,2,1,3,Immediate,Relevant,Animation,1,1
70,R_3iJOajCiVtMpx3N,18.11666667,0,3,8,11,5,6.75,7,1,1,2,4,12,16,0,0,0,0,1,1,Immediate,Irrelevant,Static,1,1
71,R_1hJZYXk6wAefHCZ,25.5,0,2,0,2,6.333333333,6.75,6.333333333,0,1,1,2,8,10,0,1,1,2,1,3,Delayed,Irrelevant,Animation,1,2
72,R_XmJ93jmUOYrZEsN,19.23333333,1,3,5,9,6.333333333,8.75,8.333333333,2,0,0,2,10,12,0,0,0,0,3,3,Immediate,Relevant,Static,1,2
73,R_24NaM0FLpOjRw89,21.5,1,2,4,7,7.333333333,9.5,0.666666667,2,0,1,3,7,10,1,1,1,3,1,4,Delayed,Relevant,Animation,1,2
74,R_V2X53o0MrbdNoKR,22.78333333,0,1,13,14,6,9,8,0,1,2,3,7,10,0,1,0,1,1,2,Immediate,Relevant,Animation,1,2
75,R_3MLrFK8lJTCmrD3,16.8,1,2,3,6,7,8.5,5.666666667,3,0,2,5,8,13,0,1,0,1,1,2,Immediate,Irrelevant,Animation,1,2
76,R_2CxMoSUhArYZmvq,20.18333333,0,1,6,7,3,6.75,8.333333333,1,0,0,1,8,9,1,1,0,2,2,4,Delayed,Irrelevant,Static,1,2
77,R_2xAjBxoeq6A0fRB,25.28333333,0,4,4,8,5.666666667,7.5,2.666666667,3,0,2,5,9,14,1,1,0,2,2,4,Delayed,Relevant,Static,1,2
78,R_Q634KGkgW0zL1xD,15.7,0,2,3,5,1.666666667,5.75,2,1,0,0,1,8,9,0,1,1,2,2,4,Immediate,Relevant,Animation,1,2
79,R_4GhbkiEfciEJX0t,17.65,1,1,8,10,5,4.5,5.333333333,0,0,1,1,4,5,1,0,0,1,1,2,Delayed,Irrelevant,Static,1,2
80,R_3lVSAwMtp5YEmng,17.45,0,1,4,5,8,8.75,6.666666667,2,0,2,4,5,9,1,0,1,2,0,2,Delayed,Irrelevant,Animation,1,2
81,R_21pqQXNhyZi37Si,31.7,2,2,11,15,2.666666667,6.25,5.666666667,2,2,1,5,9,14,1,1,0,2,1,3,Immediate,Relevant,Static,1,2
82,R_3KPDpvS5a5CcfoC,12.25,0,2,3,5,8.666666667,8,7.666666667,3,0,0,3,6,9,0,1,0,1,1,2,Immediate,Relevant,Static,1,2
83,R_1hMa4izeMuA2kyq,13.85,0,1,3,4,4.666666667,9.25,8.333333333,1,0,0,1,5,6,0,0,0,0,0,0,Delayed,Relevant,Animation,1,2
84,R_BGsFyO9prKlndBv,17.21666667,0,1,0,1,2.666666667,8.25,6.666666667,4,3,2,9,13,22,2,2,0,4,2,6,Immediate,Irrelevant,Static,1,1
85,R_21icMJJWEdgUPdN,24.06666667,1,2,0,3,4,9.5,9,6,2,2,10,12,22,1,2,0,3,1,4,Delayed,Irrelevant,Animation,1,1
86,R_2y17Fuxw7kWuzqJ,24.41666667,0,1,11,12,1.666666667,5.25,3.333333333,2,0,2,4,7,11,1,2,1,4,3,7,Delayed,Relevant,Animation,1,2
87,R_eypUdj39r2WYqhr,28.25,1,1,8,10,3.666666667,5.5,5.333333333,2,0,2,4,4,8,0,1,1,2,2,4,Immediate,Relevant,Static,1,2
88,R_1eLBO4zaG8ubacL,18.81666667,0,2,3,5,5.333333333,8.5,5.666666667,0,0,0,0,5,5,1,1,1,3,1,4,Immediate,Irrelevant,Animation,1,1
89,R_2YPKimiudeQggmx,21.33333333,2,3,6,11,9,9,5,2,0,1,3,2,5,0,0,1,1,3,4,Delayed,Irrelevant,Animation,1,1
90,R_OCOYk6XjVeq0O41,21.38333333,0,1,9,10,5,4,7,2,0,1,3,9,12,2,0,1,3,2,5,Delayed,Irrelevant,Static,1,1
91,R_1OJGZLmDRanehTW,25.8,0,1,0,1,2.333333333,6,6,2,0,0,2,5,7,0,0,0,0,2,2,Immediate,Relevant,Animation,1,2
92,R_9EMVtJxYpcGPG3T,19.01666667,1,2,7,10,6.666666667,8.5,4.666666667,4,5,3,12,11,23,1,1,0,2,3,5,Immediate,Irrelevant,Static,1,2
93,R_1IZbgPCfPmdiT4T,19.13333333,1,1,8,10,6.333333333,2.75,3.666666667,3,0,0,3,6,9,1,1,1,3,2,5,Delayed,Relevant,Static,1,2
94,R_3CJcgifulSUxRJO,9.466666667,1,3,7,11,6,9,4.333333333,1,1,2,4,10,14,1,2,0,3,2,5,Immediate,Relevant,Static,1,1
95,R_3iX48D2wJYi1zZ4,12.56666667,0,1,5,6,5.666666667,9.5,6,0,0,0,0,7,7,0,1,0,1,2,3,Immediate,Relevant,Animation,1,2
96,R_3F4NuFb5lygT9Ke,14.88333333,0,3,7,10,5.333333333,7.25,3.666666667,4,1,3,8,12,20,1,1,0,2,3,5,Delayed,Irrelevant,Static,1,1
97,R_1DBDNgBhzky8bTF,16.46666667,0,2,9,11,3,7.5,7.666666667,3,0,0,3,2,5,1,2,0,3,2,5,Delayed,Irrelevant,Animation,1,2
98,R_3ndS350JlskcUzf,20.1,2,3,6,11,5.333333333,5,6.666666667,2,0,2,4,6,10,0,1,1,2,3,5,Immediate,Relevant,Animation,1,2
99,R_1E0skSlt7QR2HHg,21.86666667,0,1,0,1,8.333333333,9.5,7,2,0,2,4,12,16,1,1,1,3,3,6,Delayed,Irrelevant,Animation,1,1
100,R_3dXFkHlV1Viw0Gh,15.56666667,0,1,1,2,2,3.75,4.666666667,3,0,0,3,7,10,1,0,1,2,1,3,Delayed,Relevant,Static,1,1
101,R_2f3sCCzJuf3CClT,21.3,0,1,8,9,4.333333333,0.75,2,1,1,1,3,11,14,1,0,0,1,1,2,Immediate,Irrelevant,Static,1,1
102,R_1GT8MOeFIbGVGsG,23.66666667,0,1,4,5,5,6.75,2.333333333,3,1,2,6,10,16,1,1,0,2,2,4,Delayed,Relevant,Animation,1,1
103,R_2s6cboJCS5mWl0E,24.41666667,0,1,0,1,4.333333333,7,5.666666667,3,0,2,5,6,11,0,1,1,2,1,3,Immediate,Irrelevant,Animation,1,2
104,R_2cchy2ESo53qchB,15.61666667,0,2,4,6,3.666666667,4.25,6.666666667,1,0,0,1,10,11,1,1,0,2,2,4,Delayed,Irrelevant,Static,1,2
105,R_20MNE3nH5nv4bCP,16.06666667,1,2,5,8,6,7,6.333333333,2,2,0,4,10,14,1,1,0,2,2,4,Immediate,Relevant,Static,1,1
106,R_WBBUag7KwnuY7pn,25.23333333,0,1,5,6,3.333333333,6.25,4.666666667,4,2,0,6,9,15,0,1,1,2,0,2,Delayed,Irrelevant,Static,1,1
107,R_zdRANIEoZQ4IjLj,27.01666667,2,3,14,19,0,1,3.333333333,5,5,0,10,12,22,2,3,1,6,2,8,Immediate,Relevant,Static,1,1
108,R_3nNNK9mxjnWlb69,23.01666667,0,1,6,7,2.333333333,4,2,3,0,0,3,11,14,2,1,1,4,3,7,Delayed,Relevant,Animation,1,1
109,R_6fKs3y8HGWB8CFb,15.81666667,1,2,7,10,4.333333333,7.5,6.666666667,3,1,0,4,11,15,1,1,0,2,2,4,Immediate,Relevant,Static,1,2
110,R_2uL1GIZREbu4qN4,18.05,2,2,9,13,4.333333333,5.75,4,4,4,0,8,12,20,1,1,0,2,3,5,Immediate,Irrelevant,Animation,1,1
111,R_3n2wHktHEsZB4hY,27.01666667,0,2,0,2,4,8,7,1,0,0,1,6,7,1,1,2,4,2,6,Delayed,Relevant,Animation,1,2
112,R_1CkjXfM85PmLnCt,27.01666667,1,1,6,8,6.666666667,8.75,8.333333333,4,0,0,4,9,13,2,1,1,4,2,6,Delayed,Irrelevant,Animation,1,2
113,R_3frw6R7oCdZIKOv,15.4,0,2,1,3,6.666666667,6,4.333333333,0,0,0,0,7,7,0,0,0,0,1,1,Immediate,Irrelevant,Animation,1,1
114,R_TdV2xrrlt5EPNDz,9.35,0,2,4,6,3,4.75,4,1,0,0,1,6,7,0,0,0,0,0,0,Delayed,Relevant,Animation,1,1
115,R_AyNGoUvXFzu3cFr,21.2,0,1,1,2,8.333333333,8.25,6.666666667,1,0,0,1,8,9,1,1,1,3,0,3,Immediate,Irrelevant,Static,1,2
116,R_29ndUZ62NC09E4o,21.9,0,3,7,10,3.333333333,3,10,3,0,0,3,9,12,0,1,0,1,2,3,Delayed,Irrelevant,Static,1,2
117,R_2rHOoZaBXouslux,15.33333333,1,1,1,3,5,5.75,3.666666667,0,0,0,0,9,9,1,1,0,2,2,4,Immediate,Relevant,Static,1,2
118,R_2CwS9cGpJ2CYxKE,17.63333333,0,1,0,1,6.666666667,4.25,4.666666667,1,0,0,1,5,6,1,0,0,1,3,4,Delayed,Relevant,Static,1,2
119,R_1H2dfFnJPosfoAM,20.45,0,1,1,2,2.666666667,3.25,9.666666667,5,0,0,5,6,11,1,0,1,2,1,3,Delayed,Irrelevant,Static,1,2
120,R_2CVwrOkVVqY5v0i,24.85,0,3,9,12,5.666666667,8.5,9,3,2,2,7,10,17,1,1,1,3,3,6,Immediate,Irrelevant,Animation,1,2
121,R_Zklfe50BufeWNH3,13.38333333,0,1,0,1,5,8.5,6,1,0,0,1,6,7,1,1,1,3,3,6,Immediate,Relevant,Animation,1,2
122,R_1NfvfJ0IKsNcpcu,16.35,0,2,4,6,2,2,7.666666667,1,0,0,1,5,6,1,0,2,3,1,4,Immediate,Relevant,Static,1,2
123,R_25ttyUMKHux7PIw,21.13333333,0,1,0,1,6.666666667,8,6,0,0,0,0,8,8,1,1,1,3,2,5,Delayed,Relevant,Animation,2,2
124,R_bQKCthUINMrDRAt,24.58333333,0,2,4,6,3.333333333,6.25,3.666666667,2,0,2,4,10,14,1,1,0,2,1,3,Immediate,Irrelevant,Animation,1,2
125,R_2332YTsYtYKP4Ao,22.16666667,0,2,2,4,4,6.5,4,3,2,3,8,11,19,0,1,0,1,1,2,Delayed,Irrelevant,Static,1,1
126,R_33lNbdTfFnZ6VLq,14,0,2,3,5,6,7.75,4.666666667,2,0,1,3,9,12,2,2,1,5,2,7,Delayed,Relevant,Animation,1,2
127,R_3fpd1dkCZLWHPQm,20.41666667,1,1,1,3,4,6.75,5,3,0,1,4,9,13,2,1,0,3,1,4,Immediate,Relevant,Static,1,1
128,R_2qC1LqvYqlspFkF,20.33333333,0,1,0,1,3,4.75,5.666666667,1,0,0,1,9,10,1,1,1,3,3,6,Delayed,Irrelevant,Animation,1,2
129,R_1r247ZNxBdFySy3,14.75,0,4,4,8,4.333333333,5.5,4,1,0,0,1,8,9,1,1,1,3,1,4,Immediate,Irrelevant,Static,1,1
130,R_1K87B6MzEzXN5ET,19.71666667,0,2,2,4,6,5.75,3,4,1,3,8,10,18,2,1,0,3,3,6,Delayed,Irrelevant,Animation,1,1
131,R_2TZVRqUIK7oq35c,20.13333333,0,1,3,4,2.666666667,8.25,7,1,1,0,2,10,12,2,1,1,4,2,6,Immediate,Relevant,Animation,1,1
132,R_1rvLAmRFwPfoSoh,22.03333333,2,2,4,8,4.333333333,4.75,5.333333333,2,3,2,7,10,17,2,1,1,4,2,6,Immediate,Irrelevant,Static,1,1
133,R_27ya2HZMSCw7Hfr,18.7,0,1,0,1,3,6,2,1,0,2,3,4,7,1,1,1,3,1,4,Immediate,Relevant,Animation,1,1
134,R_3nBDPcZqcULlrk1,19.81666667,0,1,2,3,3.666666667,8,6,1,0,1,2,5,7,1,1,0,2,2,4,Delayed,Relevant,Static,1,1
135,R_2CNCgAgOhbQiWqc,21.16666667,0,2,9,11,5.666666667,7.75,8,3,0,0,3,5,8,2,1,0,3,2,5,Delayed,Irrelevant,Static,1,1
136,R_22nNFKyoiukzqxm,22.9,1,1,2,4,6.333333333,6.5,5.666666667,1,4,2,7,9,16,1,1,1,3,2,5,Delayed,Relevant,Static,1,1
137,R_2Yb6DTCLAGcqYxJ,21.53333333,0,2,7,9,7,7.5,7.666666667,4,0,0,4,6,10,1,1,0,2,3,5,Immediate,Irrelevant,Animation,1,2
138,R_29ndVNEwOsCscwC,13.3,0,3,11,14,3.333333333,6,10,0,0,0,0,5,5,0,1,0,1,1,2,Immediate,Irrelevant,Animation,2,2
139,R_2rj5SO8M8lNScfR,16.38333333,1,2,9,12,6.666666667,7.75,7,4,0,0,4,9,13,1,1,1,3,3,6,Delayed,Irrelevant,Static,1,2
140,R_3RczhZPNQbtNvLr,19.28333333,2,1,6,9,6.666666667,3.25,8,0,0,2,2,10,12,1,1,0,2,3,5,Delayed,Relevant,Static,1,2
141,R_31cNsA9LzWxViJU,10.36666667,0,1,4,5,5.333333333,7.5,5,2,0,0,2,4,6,1,1,0,2,3,5,Immediate,Relevant ,Animation,1,1
142,R_3JDDbqUzISOqwII,15.36666667,0,3,8,11,4.333333333,7,5.333333333,2,0,0,2,7,9,1,0,1,2,3,5,Delayed,Irrelevant,Animation,1,1
143,R_2pQ3RDedmSkBqO4,17.05,1,3,2,6,4.666666667,5.25,5,2,0,1,3,11,14,1,0,1,2,3,5,Delayed,Irrelevant,Static,1,2
144,R_1nZ9Bx1C3FLz6KZ,21.33333333,0,2,4,6,4.333333333,5,7.333333333,1,1,2,4,11,15,1,1,0,2,1,3,Immediate,Relevant ,Static,1,1
145,R_2rVJD7aXSG1WvHz,20.6,0,1,5,6,5.333333333,8,2,1,1,0,2,9,11,1,1,1,3,1,4,Immediate,Irrelevant,Animation,1,1
146,R_1gT3J5oOLKclp3K,47.23333333,2,3,9,14,8,6.5,2,7,4,3,14,11,25,2,1,1,4,3,7,Delayed,Relevant ,Static,1,1
147,R_2CTf139uT83tPJm,25.3,1,1,0,2,5.666666667,8.5,7,2,1,2,5,10,15,1,1,1,3,1,4,Delayed,Relevant ,Animation,1,2
148,R_Y342Qt61baEPpp7,9.616666667,0,1,1,2,0,0,1,0,0,0,0,5,5,1,0,0,1,2,3,Immediate,Irrelevant,Static,2,2
149,R_27BY02XNkTu0CSn,23.96666667,2,2,9,13,6.666666667,4,2.666666667,3,1,2,6,10,16,1,2,1,4,3,7,Immediate,Irrelevant,Animation,1,1
150,R_2rU6g6zpIqJSW3o,38.7,1,2,3,6,4.666666667,4.75,4.666666667,4,2,2,8,12,20,2,1,0,3,2,5,Delayed,Relevant ,Static,1,2
151,R_2V4sEzaORXMlPhh,19.06666667,0,3,7,10,3,8.25,7,0,0,2,2,10,12,1,1,0,2,0,2,Immediate,Irrelevant,Static,1,2
152,R_1pG16c4nVhIFKW4,21.75,3,1,9,13,5.666666667,7,8,4,1,1,6,8,14,2,1,0,3,1,4,Immediate,Irrelevant,Animation,1,2
153,R_1rBN6fye5iSnvj1,23.83333333,2,1,9,12,6,9.25,8.666666667,4,4,2,10,11,21,2,2,1,5,2,7,Immediate,Relevant,Static,1,1
154,R_29tQX2suMiDeS3i,17.83333333,0,2,0,2,4,6.5,7,2,0,0,2,6,8,2,1,1,4,1,5,Immediate,Irrelevant,Static,1,2
155,R_2ZOJhj8LKnhgdAi,14.5,0,1,2,3,3.666666667,5.25,3,2,0,0,2,6,8,1,1,0,2,1,3,Delayed,Irrelevant,Animation,1,1
156,R_2aeoxYQO3pTVwta,20.2,0,1,1,2,6,9.5,5.666666667,4,1,0,5,8,13,0,1,0,1,0,1,Immediate,Relevant,Static,1,2
157,R_125ArgTqmJs14wt,18.45,1,2,7,10,3.666666667,7.75,4,1,0,0,1,11,12,0,1,0,1,1,2,Delayed,Relevant,Animation,1,1
158,R_2dRRVJBRYF80GwR,32.76666667,1,1,4,6,4.666666667,6.75,7.333333333,3,2,1,6,13,19,1,2,1,4,3,7,Immediate,Relevant ,Static,1,1
159,R_3KUFuedtLys4wBB,23.75,0,1,6,7,3.666666667,6.75,7,2,1,2,5,7,12,1,1,0,2,3,5,Delayed,Irrelevant,Static,1,2
160,R_3FIIPDsUZjNVeFu,25.58333333,0,2,6,8,5.333333333,7,6.666666667,4,0,1,5,10,15,2,1,0,3,3,6,Delayed,Irrelevant,Animation,1,1
161,R_0BYxbDVccHx0To5,20.46666667,1,1,0,2,7.333333333,9.75,8,2,0,1,3,9,12,1,0,0,1,2,3,Immediate,Relevant,Animation,1,2
162,R_3Eb3IPTp8arAL5m,20.18333333,0,1,7,8,4,5.75,4.666666667,4,1,2,7,10,17,1,2,0,3,3,6,Delayed,Relevant,Static,1,2
163,R_ZlxmwU4ukee3K2B,18.7,0,1,1,2,7.333333333,4.75,8.333333333,4,0,0,4,5,9,1,0,1,2,0,2,Immediate,Irrelevant,Animation,1,2
164,R_20Pf86nT2o2yMor,22.91666667,1,1,5,7,7.666666667,1.5,2.333333333,2,1,2,5,11,16,1,1,1,3,2,5,Immediate,Relevant,Animation,1,2
165,R_3nN08HB3Nkhs4Hr,26.76666667,0,1,7,8,3,5.5,6.666666667,2,1,1,4,11,15,1,1,0,2,3,5,Delayed,Irrelevant,Static,1,2
166,R_2yr2DlimmSJdrI3,28.23333333,2,3,6,11,1.333333333,1.5,2,1,0,0,1,9,10,1,1,0,2,3,5,Immediate,Relevant,Animation,2,2
167,R_3fV5f0cOFyFmiji,24.01666667,1,2,5,8,6,7.5,7.333333333,2,0,1,3,6,9,0,1,1,2,3,5,Delayed,Irrelevant,Static,1,2
168,R_3PAy4UZPWI7pB3s,23.88333333,0,1,5,6,6,2,2,3,7,0,10,12,22,1,1,0,2,3,5,Delayed,Irrelevant,Animation,1,2
169,R_1GHOty8aVBbt1Dn,23.66666667,1,2,7,10,8.666666667,6,3.333333333,1,2,0,3,10,13,1,1,0,2,1,3,Immediate,Irrelevant,Static,1,1
170,R_3Mh5tZy8HHseC0F,27.73333333,0,2,2,4,5.666666667,2.5,2,3,0,0,3,8,11,1,1,0,2,2,4,Immediate,Relevant,Static,1,2
171,R_28Bfy902Zzf2s5j,20.46666667,3,4,5,12,5.333333333,0.5,3,3,6,3,12,10,22,1,1,1,3,2,5,Delayed,Relevant,Static,1,2
172,R_3iWmHuVPwmm8O56,23.38333333,1,1,0,2,7.666666667,7.25,8.666666667,5,0,1,6,12,18,1,1,1,3,0,3,Delayed,Irrelevant,Animation,1,2
173,R_2xCZkfqiChsqIrN,33.05,2,1,8,11,3.666666667,2,5.666666667,3,3,1,7,9,16,0,1,0,1,2,3,Immediate,Relevant,Animation,1,2
174,R_1N997zLhEQ28uyT,16.1,0,1,6,7,4,2,3.333333333,4,0,0,4,10,14,2,1,0,3,2,5,Delayed,Irrelevant,Static,1,1
175,R_3NV9CjoPdRAXNgY,24.33333333,1,2,6,9,8.333333333,7.5,4.666666667,3,0,2,5,11,16,1,2,0,3,0,3,Immediate,Relevant,Static,1,1
176,R_2ydt0Yr1ubitByb,22.21666667,0,3,2,5,6,4.75,5,3,0,0,3,7,10,1,1,0,2,1,3,Delayed,Relevant,Animation,1,2
177,R_w7uHNMaf1katZqF,22.1,0,1,12,13,6.666666667,3.5,3,6,0,0,6,11,17,2,1,1,4,1,5,Immediate,Irrelevant,Animation,1,2
178,R_30kSRlbnXUBBglK,27.91666667,0,3,6,9,7,1.5,2,2,0,0,2,2,4,0,0,0,0,0,0,Immediate,Irrelevant,Animation,2,2
179,R_2EcUSNOnNKqkVhk,20.3,0,1,0,1,6.666666667,2.5,5.666666667,0,0,0,0,10,10,0,0,0,0,2,2,Delayed,Relevant,Static,1,1
180,R_1QMDrs9YEX288Ex,29.28333333,1,2,5,8,4.666666667,3.75,3,4,4,3,11,11,22,2,1,0,3,3,6,Immediate,Relevant,Animation,1,1
181,R_1OBSMRqR2dlhG6k,36.33333333,0,1,4,5,3,1.75,5.333333333,2,0,2,4,9,13,1,0,1,2,2,4,Delayed,Irrelevant,Animation,1,2
182,R_3G20eVixBMtXDAq,62.21666667,0,1,0,1,10,5.25,2.666666667,1,5,0,6,9,15,0,1,0,1,2,3,Delayed,Relevant,Animation,1,1
183,R_sj0u3oBdezQRRKN,15.65,1,4,12,17,6,3.25,5.666666667,4,0,1,5,6,11,0,1,0,1,1,2,Immediate,Relevant,Static,1,1
184,R_r6dTghoV1vHZ2nv,21.3,1,3,4,8,9,2,9,1,1,0,2,3,5,0,1,0,1,2,3,Delayed,Irrelevant,Static,1,2
185,R_1NtE0IvsxeF3f0A,15.45,0,3,10,13,6,7.75,4,2,0,0,2,5,7,0,1,0,1,3,4,Immediate,Relevant,Static,1,2
186,R_qRxwSpSeoKksodX,17.03333333,0,1,1,2,3,8,6.333333333,4,0,0,4,7,11,1,1,0,2,0,2,Immediate,Irrelevant,Animation,1,2
187,R_1E6cdp7LCad9aST,17.78333333,1,2,2,5,5.333333333,5.25,4,2,1,0,3,9,12,1,0,0,1,1,2,Delayed,Irrelevant,Static,1,2
188,R_1ilBByn0ViK9Z2m,18.4,0,1,3,4,7,8.5,6,1,0,0,1,10,11,1,1,1,3,2,5,Immediate,Irrelevant,Static,1,1
189,R_3NQmhmcqTftk8Hg,20.1,2,3,12,17,8,8,5,2,0,2,4,9,13,0,1,0,1,2,3,Delayed,Relevant,Static,1,1
190,R_ugpBbyQ0ZQExfJ7,23.2,1,1,0,2,7.333333333,8.75,7,2,1,0,3,10,13,0,1,0,1,1,2,Delayed,Relevant,Animation,2,1
191,R_zUqN7PdRbXfX59D,19.95,1,1,0,2,2.666666667,6.75,7.333333333,3,1,1,5,12,17,0,2,1,3,3,6,Immediate,Relevant,Animation,1,1
192,R_3oAViQUsLhGrcXY,17.3,0,2,2,4,6,4.5,4.666666667,1,1,1,3,10,13,0,1,0,1,1,2,Delayed,Irrelevant,Animation,1,2
193,R_Qc3TEgjxA9h0P0B,32.28333333,0,1,8,9,4.666666667,6,7.666666667,1,0,0,1,9,10,0,2,1,3,3,6,Delayed,Irrelevant,Animation,1,2
194,R_2EntdOfYQmJf3K3,11.96666667,2,3,8,13,3.333333333,5.5,5,1,0,1,2,3,5,0,0,0,0,2,2,Delayed,Irrelevant,Animation,1,2
195,R_2VRavSPTzB1PXCM,17.03333333,2,3,8,13,5.333333333,9,9,2,2,0,4,6,10,0,1,0,1,0,1,Delayed,Relevant,Static,1,2
196,R_22lwwAaqWpwEqXP,20.15,0,2,3,5,5,8.75,10,2,0,0,2,4,6,1,2,0,3,3,6,Immediate,Irrelevant,Static,,
197,R_87FhVvXc8snWFYl,54.06666667,0,1,2,3,3,4.25,8,3,2,0,5,10,15,2,1,0,3,1,4,Immediate,Relevant,Animation,1,2
198,R_1DYZKhuOd5Ij5db,17.73333333,1,2,7,10,5.666666667,7.5,6.666666667,4,2,2,8,8,16,1,1,1,3,2,5,Immediate,Irrelevant,Static,1,2
199,R_2axHcpq0Fr4MUSv,19.11666667,0,1,4,5,4.333333333,7.5,7.333333333,2,0,2,4,10,14,0,1,0,1,1,2,Immediate,Irrelevant,Animation,1,2
200,R_2QzBvYwK8IZzV5m,19.2,1,1,1,3,3,7.75,7.666666667,1,0,0,1,10,11,1,1,1,3,2,5,Delayed,Relevant,Static,1,2
201,R_3feEhEnCaLuYlrI,24.61666667,0,1,6,7,5,6.75,5.333333333,2,0,0,2,10,12,0,1,1,2,1,3,Immediate,Relevant,Animation,1,1
202,R_BzAJR60PVutj4pb,15.1,0,2,6,8,2,4.5,3.333333333,1,0,1,2,5,7,1,1,0,2,1,3,Delayed,Relevant,Static,1,1
203,R_33lL4TwL9hGGehi,23.51666667,0,2,7,9,7.666666667,8,5.666666667,2,0,2,4,7,11,0,0,0,0,1,1,Delayed,Irrelevant,Static,1,2
204,R_1Kjy39adbhUs2SW,26.21666667,2,1,2,5,5.666666667,7,6.333333333,2,1,3,6,9,15,0,1,0,1,2,3,Immediate,Relevant,Animation,1,1
205,R_3puqvF60S7S3OXb,27.71666667,2,2,2,6,5,8,6,4,0,0,4,10,14,1,0,1,2,2,4,Immediate,Irrelevant,Animation,1,1
206,R_1jqA4bfWp87mkcf,21.11666667,1,3,7,11,6.333333333,7.75,6.666666667,5,2,0,7,11,18,0,0,0,0,1,1,Immediate,Relevant,Animation,1,1
207,R_3k5qHX4TSiBg5f1,22.65,2,1,7,10,7.666666667,9.75,8.666666667,1,0,0,1,8,9,1,1,0,2,2,4,Delayed,Irrelevant,Static,1,2
208,R_3r0rwhdnc4CEDnX,23.43333333,0,2,0,2,4,6.25,5,3,0,0,3,8,11,2,1,0,3,2,5,Delayed,Relevant,Static,1,2
209,R_2eai0tWS3LGE2xa,16.66666667,2,1,3,6,6.333333333,9.5,7,4,0,2,6,9,15,2,1,0,3,2,5,Immediate,Relevant,Static,1,1
210,R_3eknokQeTZRKxWH,19.68333333,0,4,2,6,4,4.75,5.666666667,0,0,0,0,6,6,1,0,1,2,3,5,Delayed,Relevant,Animation,1,2
211,R_ezb7IWrMQzEniQp,22.31666667,2,3,1,6,3,7.25,7.333333333,3,1,2,6,11,17,1,1,1,3,3,6,Delayed,Irrelevant,Static,1,1
212,R_3DqFeiuzMe4dGIB,24.1,0,3,4,7,4,8,8,4,0,2,6,7,13,0,2,0,2,3,5,Delayed,Relevant,Animation,1,1
213,R_2rARp8ZA4siGQ5z,23.53333333,0,1,3,4,2.333333333,6.25,3.666666667,4,0,1,5,6,11,0,1,0,1,2,3,Immediate,Irrelevant,Static,2,2
214,R_sZ3rMmpdAEPGCyJ,17.56666667,3,2,5,10,2.333333333,3.25,4.333333333,4,0,2,6,9,15,1,1,0,2,2,4,Delayed,Relevant,Static,1,1
215,R_33qo6OCJqu2nn3u,19.93333333,0,3,2,5,5.333333333,4.5,6.333333333,4,0,2,6,10,16,1,1,1,3,2,5,Immediate,Irrelevant,Animation,1,1
216,R_BK4pqg1xj7aYGeR,23.05,0,1,8,9,7.333333333,7,7,3,2,3,8,12,20,1,1,0,2,2,4,Immediate,Irrelevant,Animation,1,2
217,R_2YyKi8HMao1cdUW,31.73333333,0,1,9,10,5.333333333,5.25,7.333333333,5,0,1,6,10,16,2,1,0,3,2,5,Immediate,Relevant,Static,1,2
218,R_3KqP1Y5E2RWfRpQ,32.51666667,0,2,11,13,9.666666667,10,7,4,3,0,7,12,19,2,1,0,3,3,6,Delayed,Relevant,Animation,1,1
219,R_1C73oMI4JXxO4vA,23.55,0,3,6,9,5.333333333,6.5,4,1,0,0,1,8,9,1,1,1,3,1,4,Delayed,Irrelevant,Static,1,2
220,R_1FnV1uSCXPHFX9Q,27.6,0,1,0,1,4.333333333,4.25,4,0,0,0,0,7,7,0,1,0,1,2,3,Immediate,Relevant,Static,1,2
221,R_1lzOZ94Ofpugx6u,20.33333333,0,1,1,2,1.666666667,7.5,3,1,0,1,2,10,12,1,2,0,3,2,5,Delayed,Relevant,Animation,1,1
222,R_2S7zcdORvRqrAM2,20.4,0,1,4,5,6.333333333,8.5,6.333333333,5,0,1,6,10,16,1,1,0,2,2,4,Delayed,Irrelevant,Animation,1,1
223,R_pAdpDij3bfiz0oF,20.18333333,1,2,6,9,7,8,9,3,0,1,4,8,12,1,1,0,2,2,4,Immediate,Irrelevant,Static,1,1
224,R_3jeLWW45S771MsL,27.8,1,3,1,5,5,6.5,1.333333333,2,0,1,3,9,12,1,1,1,3,3,6,Delayed,Relevant,Static,1,1
225,R_3etdX7QKxyjpgE0,28.7,1,1,8,10,6,5.5,7,5,2,2,9,10,19,1,1,1,3,3,6,Immediate,Irrelevant,Static,1,1
226,R_2WD7ZEJOyEodo90,30.9,1,1,0,2,4,7.75,2.666666667,2,2,0,4,7,11,0,0,0,0,1,1,Delayed,Irrelevant,Animation,1,2
227,R_3snzpKYNqNRf3lH,25.38333333,1,2,9,12,4.333333333,8.25,9,4,4,1,9,9,18,0,1,0,1,1,2,Immediate,Relevant,Animation,1,1
228,R_5znBIeOkiFJCKvD,19.81666667,0,1,3,4,3.333333333,8.5,7.666666667,1,1,0,2,13,15,1,1,1,3,1,4,Delayed,Relevant,Animation,1,1
229,R_3MSBlTaChUG8frQ,30.91666667,0,2,1,3,3.666666667,10,8.333333333,3,0,0,3,8,11,0,1,1,2,1,3,Immediate,Relevant,Static,1,2
230,R_30jyvxE3DMl2H8Q,17.91666667,1,1,7,9,4.333333333,8.25,4.666666667,3,0,1,4,10,14,1,1,0,2,3,5,Delayed,Irrelevant,Static,1,1
231,R_1KxOkpPhvCT04HU,20.61666667,0,1,7,8,4.333333333,7.5,9.666666667,1,1,0,2,7,9,1,2,1,4,2,6,Immediate,Irrelevant,Animation,1,1
232,R_3JfsniLlfZFXoyW,18.33333333,0,1,4,5,5.666666667,6,8.666666667,2,0,1,3,5,8,1,1,0,2,3,5,Delayed,Relevant,Static,1,2
233,R_30oDnfqZW37ChiX,15.45,2,1,2,5,5,9.5,5.666666667,4,1,1,6,10,16,2,1,0,3,3,6,Immediate,Irrelevant,Static,1,1
234,R_xsiszCb3yHirCAF,19.26666667,0,1,0,1,7,9.5,5.666666667,1,0,0,1,2,3,0,0,0,0,1,1,Delayed,Irrelevant,Animation,1,2
235,R_ZKL3pCgkallfA4x,22.35,0,1,4,5,8.666666667,8,1,3,1,0,4,6,10,2,1,0,3,2,5,Immediate,Relevant,Animation,1,1
236,R_2pS44EYuZdyJitK,17.41666667,2,1,6,9,4.333333333,7.5,5.666666667,3,0,1,4,4,8,0,1,0,1,3,4,Delayed,Relevant,Animation,1,2
237,R_2YMsJXMA1fz4Nq9,24.58333333,0,2,4,6,4,8,1.666666667,3,0,0,3,10,13,0,0,0,0,2,2,Immediate,Irrelevant,Animation,1,1
238,R_DDjJcIlobmpkMrD,25.28333333,3,2,7,12,5.666666667,9.5,7.666666667,4,1,0,5,11,16,1,1,0,2,1,3,Delayed,Relevant,Static,1,1
239,R_r0XCFwpaClvkQyB,13.66666667,0,1,0,1,6.333333333,9,3.666666667,1,0,1,2,8,10,0,0,1,1,2,3,Immediate,Irrelevant,Static,1,1
240,R_294iejcD3UUyPqR,14.25,0,1,0,1,4.666666667,5.25,4.333333333,3,0,1,4,6,10,2,0,0,2,2,4,Immediate,Irrelevant,Static,1,2
241,R_SNMELUmpNIDMG6l,21.41666667,2,3,7,12,3,9,7.333333333,5,7,2,14,13,27,1,1,0,2,2,4,Delayed,Relevant,Animation,1,1
242,R_1K20RBWenV0qIaG,22.98333333,1,3,3,7,2.666666667,5.25,5.666666667,1,0,0,1,7,8,1,1,0,2,0,2,Immediate,Relevant,Static,1,1
243,R_2TBIAsjWo1XzuKL,19.01666667,1,1,4,6,4.666666667,8,4.333333333,2,1,2,5,6,11,1,1,0,2,2,4,Delayed,Irrelevant,Animation,1,1
244,R_7OGhaeqM8i7SW41,22.96666667,0,1,3,4,5,8.75,4.666666667,1,0,0,1,9,10,0,2,0,2,2,4,Delayed,Relevant,Static,1,1
245,R_3rWXRRxFlGJrJC1,24.5,0,3,3,6,4.333333333,8.25,9.333333333,3,0,1,4,7,11,1,0,1,2,2,4,Immediate,Irrelevant,Static,1,1
246,R_3rZqcIKfdgARb0q,12.86666667,0,1,0,1,0,9.25,6.666666667,1,0,0,1,3,4,0,1,0,1,2,3,Immediate,Relevant,Animation,1,1
247,R_1NxXEGDY4u1A7jI,21.73333333,1,1,5,7,4,8.25,9,2,1,3,6,8,14,2,1,0,3,2,5,Delayed,Irrelevant,Animation,1,1
248,R_2co1iQBxmYhwc67,12.33333333,0,2,3,5,4,5,3,1,2,0,3,6,9,1,1,1,3,2,5,Immediate,Relevant,Static,1,1
249,R_2ciq2GuA6P0FAGz,25.2,0,2,2,4,2.333333333,5,6,7,2,1,10,10,20,1,1,1,3,2,5,Delayed,Irrelevant,Static,1,1
250,R_3lPiighZHmUqQql,28.86666667,0,2,4,6,4,4.5,4.333333333,2,0,0,2,6,8,1,1,0,2,0,2,Immediate,Relevant,Animation,1,1
251,R_0rjIIjIVg2Ea1EZ,27.05,2,3,12,17,2.666666667,4,3,4,2,1,7,9,16,0,1,0,1,1,2,Delayed,Irrelevant,Animation,1,2
252,R_2ZC9W7RZok8UUFo,16.15,1,2,3,6,3.666666667,5.5,6.333333333,1,0,2,3,9,12,1,1,1,3,1,4,Immediate,Relevant,Static,1,1
253,R_2uKdFU0JCG7PlCa,26.3,3,4,5,12,3,8,5.333333333,3,1,2,6,11,17,2,1,0,3,3,6,Immediate,Relevant,Animation,1,1
254,R_3shqUWRjqPH1Hz7,55.86666667,0,2,9,11,3,7,5,3,1,2,6,12,18,1,1,1,3,2,5,Delayed,Irrelevant,Static,1,2
255,R_3hzRPX4981LfD4W,21.28333333,2,1,3,6,7,8.25,3,2,0,2,4,9,13,1,1,0,2,2,4,Immediate,Irrelevant,Static,1,1
256,R_1H0oURjQmchhOPt,25.81666667,0,1,7,8,4,8.25,5,2,0,2,4,10,14,2,1,1,4,2,6,Delayed,Irrelevant,Animation,1,1
257,R_2Tv29wT9fxnfF4b,29.45,2,3,7,12,6.333333333,6.25,4,5,1,2,8,12,20,1,1,0,2,2,4,Delayed,Irrelevant,Animation,1,2
258,R_8iFBUzt31JKivyV,33.61666667,0,1,5,6,3.666666667,9.5,6.666666667,2,0,0,2,6,8,0,1,1,2,1,3,Immediate,Relevant,Static,1,2
259,R_3RlIyCpFDPZ8BOQ,16.4,0,1,4,5,2,7.5,3,2,0,1,3,6,9,1,0,1,2,1,3,Delayed,Relevant,Animation,1,1
260,R_1EhTEkx9sEzXEIQ,16.51666667,0,1,0,1,0.333333333,3.75,0,3,0,0,3,5,8,1,1,0,2,1,3,Immediate,Irrelevant,Static,1,1
261,R_1jOOjGKVbgh9Y0q,18.63333333,0,2,3,5,7,6.5,9,1,0,1,2,3,5,0,1,0,1,2,3,Delayed,Relevant,Animation,1,2
262,R_ODoyJrZR3umAXrH,21.01666667,0,1,0,1,6.333333333,9,8.333333333,1,1,0,2,11,13,1,1,0,2,2,4,Immediate,Irrelevant,Animation,1,2
263,R_2DRzAz83H6ivMmI,20.1,1,2,7,10,3.666666667,5.25,6.333333333,2,0,1,3,8,11,0,1,1,2,2,4,Delayed,Relevant,Static,1,1
264,R_2wKMUyNoOb0O93M,27.91666667,0,1,0,1,2.666666667,5.5,3,2,0,0,2,6,8,0,1,0,1,1,2,Delayed,Relevant,Static,1,2
265,R_efyKCMSa65Ze3W9,15.03333333,0,2,4,6,3,4.5,4,0,0,2,2,8,10,1,1,1,3,1,4,Immediate,Relevant,Animation,1,2
266,R_2R24Rt83G6mg9Pg,22.33333333,1,1,2,4,7.333333333,6.5,7,3,3,2,8,11,19,1,0,0,1,1,2,Immediate,Irrelevant,Animation,1,1
267,R_1IhgslvZXma5nBi,24.53333333,2,3,5,10,3.666666667,7.25,5.333333333,2,0,3,5,5,10,1,0,1,2,2,4,Delayed,Irrelevant,Static,1,1
268,R_1jUuXLXWro9GiWN,25.35,0,3,5,8,7,8.5,5.666666667,2,0,1,3,8,11,1,1,1,3,2,5,Delayed,Irrelevant,Static,1,1
269,R_10Nqeo8XBmUf4ih,16.35,0,1,1,2,4.666666667,5.75,3,1,0,0,1,6,7,1,0,0,1,1,2,Immediate,Irrelevant,Animation,1,1
270,R_e9fDgIobd3Tq1m9,16.8,0,1,0,1,2.333333333,4,2.666666667,4,0,1,5,7,12,1,1,1,3,2,5,Immediate,Relevant,Animation,1,1
271,R_3L0eQs5C3iQDfgY,55.03333333,1,3,8,12,5,5.75,7,5,0,0,5,10,15,0,1,0,1,0,1,Delayed,Relevant,Static,1,2
272,R_2BfypY2BRR7JLkk,22.01666667,0,1,1,2,3,8,6.666666667,1,0,0,1,8,9,0,1,1,2,2,4,Immediate,Relevant,Static,1,2
273,R_9TATJVhCfggujSN,23.06666667,1,1,0,2,2.666666667,7.5,5.333333333,3,0,0,3,5,8,2,1,1,4,3,7,Delayed,Irrelevant,Animation,1,1
274,R_Xu0gpXYKtP7bxol,23.11666667,2,2,8,12,7.333333333,7.5,10,4,0,1,5,6,11,1,1,0,2,2,4,Immediate,Relevant,Static,1,1
275,R_AHAYvPkGpduxarT,24.8,0,1,3,4,5,8.25,7.333333333,2,1,1,4,11,15,2,1,1,4,2,6,Immediate,Irrelevant,Static,1,1
276,R_sApH8Pgyyntisxj,20.83333333,0,1,0,1,4.333333333,6.5,5,0,0,1,1,6,7,1,0,0,1,1,2,Immediate,Relevant,Animation,2,2
277,R_D8jFeaEIGrAK3mh,23.68333333,0,2,0,2,7,8,4.666666667,1,0,0,1,5,6,0,0,1,1,0,1,Delayed,Relevant,Animation,2,2
278,R_3Lj8SS53ezEXCgg,30.6,0,3,1,4,10,10,9,2,0,0,2,7,9,0,1,0,1,2,3,Delayed,Irrelevant,Animation,1,2
279,R_2ASEW2oCDfTUdUx,29.75,0,3,2,5,5.666666667,10,3.333333333,2,2,0,4,5,9,0,2,0,2,2,4,Delayed,Irrelevant,Static,1,2
280,R_1pDtcEsIidRFkMN,26.53333333,1,1,9,11,4,7.75,5,5,0,0,5,11,16,1,1,0,2,1,3,Immediate,Relevant,Static,1,1
281,R_AndRsH1KrqNXHsR,29.51666667,1,1,3,5,0.666666667,3,0.333333333,2,0,0,2,5,7,1,0,0,1,2,3,Delayed,Irrelevant,Static,1,1
282,R_264tqB4IYFixof7,21.8,0,2,0,2,5,9,4.666666667,0,0,0,0,4,4,1,0,0,1,2,3,Immediate,Irrelevant,Animation,1,2
283,R_28H9XohPlyPc5IT,23.7,0,1,4,5,5.333333333,7.25,6,4,0,2,6,11,17,2,1,1,4,2,6,Immediate,Relevant,Static,1,2
284,R_3emn56kn8fbtK4r,24.81666667,0,1,3,4,3.333333333,7.25,6.666666667,1,0,2,3,8,11,0,0,0,0,2,2,Delayed,Relevant,Animation,1,2
285,R_3J8A2gq5POuRuHN,19.03333333,1,3,8,12,8.333333333,8.25,9.333333333,2,0,3,5,4,9,0,1,0,1,2,3,Delayed,Irrelevant,Animation,1,2
286,R_2dm5QVerB3N7ttS,24.95,1,1,0,2,9.333333333,9.25,6.333333333,5,2,2,9,12,21,1,1,1,3,2,5,Immediate,Relevant,Animation,,1
287,R_3s5koToOFmqlzCZ,27.98333333,1,3,4,8,6,6.75,5.666666667,3,0,2,5,6,11,1,1,1,3,2,5,Delayed,Irrelevant,Static,1,1
288,R_wSrWtwhFNERWFuV,24.08333333,0,3,0,3,4.666666667,7.5,1.666666667,0,0,0,0,2,2,0,1,0,1,1,2,Immediate,Relevant,Animation,1,2
289,R_3p4rbNmP1Kp0gqD,18.61666667,1,2,0,3,5.666666667,9,8,5,0,0,5,9,14,0,1,0,1,1,2,Immediate,Relevant,Static,1,1
290,R_1QxUhmgSBpA6hdc,20.31666667,1,1,1,3,2,3.75,6.666666667,2,0,0,2,9,11,1,1,1,3,1,4,Delayed,Irrelevant,Static,1,1
291,R_3MzL6SMBD9C5YAy,24.28333333,0,1,0,1,1,10,2.666666667,3,1,0,4,8,12,0,1,0,1,1,2,Delayed,Irrelevant,Animation,1,1
292,R_2CQGd1xKu9tsWUN,26.48333333,0,2,5,7,1,2.5,7.333333333,1,1,0,2,10,12,0,1,0,1,1,2,Delayed,Relevant,Static,1,1
293,R_3PTRRAEROUjBYr3,21.03333333,2,2,10,14,3.333333333,7.75,7.666666667,1,0,1,2,10,12,2,1,1,4,2,6,Immediate,Irrelevant,Static,1,1
294,R_3Rkdj6jn7imohsY,25.05,2,3,8,13,6.333333333,7,4.666666667,4,2,2,8,7,15,1,1,0,2,3,5,Delayed,Relevant,Animation,1,1
295,R_2P6AMpWFYtpB32F,26.3,0,1,2,3,5.333333333,6.5,6.333333333,2,0,1,3,8,11,0,1,0,1,3,4,Immediate,Irrelevant,Animation,1,2
296,R_3RmTVy8yAKAObe5,12.6,0,3,6,9,6.666666667,7.75,4.666666667,2,0,0,2,10,12,0,1,0,1,3,4,Immediate,Relevant,Static,1,1
297,R_Y5GgCs14KQlQEW5,12.71666667,0,3,1,4,6.333333333,6,3.666666667,2,0,0,2,4,6,0,1,0,1,1,2,Immediate,Irrelevant,Animation,1,2
298,R_tDjBH5GqCqRWObL,18.75,0,3,9,12,3.333333333,8,6.666666667,3,1,2,6,9,15,1,2,1,4,3,7,Delayed,Irrelevant,Static,1,1
299,R_12RsScErxzookUy,27.2,0,2,11,13,6,6.75,6.333333333,4,7,2,13,13,26,1,1,0,2,2,4,Delayed,Relevant,Animation,1,1
300,R_1gHiRKhBi2WEkEQ,18.58333333,0,1,1,2,1.333333333,1.5,1.333333333,3,1,0,4,8,12,1,1,1,3,1,4,Delayed,Irrelevant,Static,1,2
301,R_1oon7unYkuoUvoV,20.63333333,2,3,3,8,5.666666667,6.5,3.333333333,2,0,2,4,11,15,1,1,0,2,3,5,Delayed,Irrelevant,Animation,1,1
302,R_2cwKuc0Fw4vchiI,22.31666667,0,5,1,6,3.333333333,4.25,4.666666667,1,0,0,1,5,6,0,0,0,0,1,1,Immediate,Relevant,Static,1,2
303,R_ZCNCx2kXSyfdEXL,23.36666667,0,2,7,9,5.666666667,6.75,6,2,1,1,4,12,16,1,1,0,2,3,5,Immediate,Relevant,Animation,1,1
304,R_8qUhaW2IxPBRWF3,12.58333333,0,2,0,2,5.666666667,6.5,3.666666667,2,0,0,2,6,8,0,1,0,1,1,2,Immediate,Irrelevant,Animation,2,2
305,R_3GfVVmxe2U7FiGe,23.03333333,0,2,6,8,5.333333333,7,6.666666667,2,1,2,5,9,14,2,0,0,2,2,4,Delayed,Relevant,Animation,1,1
306,R_1daXsen8UC92XdD,21.83333333,0,1,5,6,4.333333333,4.75,8.333333333,2,2,2,6,6,12,1,1,1,3,2,5,Immediate,Irrelevant,Static,1,1
307,R_2dT4ZOQ4XT0inLJ,35.96666667,2,1,3,6,4,6.75,8,1,0,0,1,11,12,2,0,1,3,2,5,Delayed,Relevant,Static,1,1
308,R_2l5gKbH7lm5ft8B,17.36666667,0,1,6,7,3,6.25,3,1,0,0,1,5,6,0,0,0,0,2,2,Delayed,Relevant,Animation,1,2
309,R_3qxTiymU8SQXfSh,19.21666667,0,2,4,6,2.666666667,6.25,5,2,1,1,4,9,13,2,1,0,3,3,6,Immediate,Irrelevant,Animation,1,2
310,R_25njYkBSfx9Pial,21.05,3,3,12,18,7,7.75,2.333333333,5,1,2,8,10,18,1,0,0,1,2,3,Immediate,Relevant,Static,2,2
311,R_3JpYItr30SW4SP3,21.3,1,2,1,4,7.333333333,8,6.666666667,1,0,3,4,12,16,2,1,1,4,1,5,Delayed,Irrelevant,Static,1,2
312,R_1d60euzAQm8NYsO,19.76666667,0,1,4,5,4.333333333,5.75,5,2,0,0,2,6,8,1,0,0,1,1,2,Delayed,Irrelevant,Static,1,2
313,R_2zhDymYZ9ASN6nm,20.03333333,2,3,7,12,5.666666667,7.25,7.333333333,2,0,1,3,10,13,0,1,1,2,2,4,Immediate,Relevant,Static,1,2
314,R_6mR4sISXtYPcwZb,23.31666667,1,2,5,8,3,9.5,7.666666667,3,2,0,5,7,12,1,1,0,2,1,3,Delayed,Relevant,Animation,1,1
315,R_2rHlRN34uAqcoeL,12.23333333,0,1,1,2,1,1,9,0,0,0,0,3,3,1,0,0,1,0,1,Immediate,Irrelevant,Animation,1,2
316,R_8q9duTwZZ8fTRiV,16.18333333,0,2,0,2,2.333333333,1.75,3,1,0,0,1,6,7,0,0,0,0,2,2,Immediate,Relevant,Static,1,1
317,R_5pvckqN1ZCPxEDD,20.48333333,3,3,13,19,3.333333333,2,5.333333333,3,1,2,6,8,14,2,0,1,3,3,6,Immediate,Irrelevant,Static,1,2
318,R_2UYHx6VYRfRxcP9,23.08333333,0,2,1,3,6.666666667,7,4.666666667,2,0,1,3,10,13,1,0,1,2,0,2,Delayed,Irrelevant,Animation,1,2
319,R_z8XdXrBBUti0LQd,45.38333333,0,1,8,9,4.333333333,6.25,6.666666667,2,0,2,4,7,11,1,1,0,2,1,3,Delayed,Relevant,Animation,1,1
320,R_3hyWv2D727mJyRf,21.83333333,2,3,12,17,7.666666667,4.75,3.333333333,4,1,1,6,10,16,1,1,0,2,3,5,Immediate,Irrelevant,Static,1,2
321,R_XTJkC4mxEFCttgR,28.33333333,0,1,3,4,5,9,5,4,2,0,6,12,18,2,1,1,4,2,6,Delayed,Relevant,Animation,1,1
322,R_2SvFPVnmPubQILF,30.2,2,1,8,11,5.666666667,5,4.333333333,2,1,1,4,8,12,1,1,1,3,3,6,Delayed,Relevant,Static,1,1
323,R_ulIEIrMf3WKnUGJ,16.7,0,1,0,1,3.333333333,5,4.333333333,0,1,0,1,8,9,0,0,1,1,2,3,Immediate,Irrelevant,Animation,1,1
324,R_2DU3goX6kzG0eDE,25.18333333,0,1,0,1,2.666666667,7.5,2,2,0,0,2,11,13,2,0,0,2,1,3,Delayed,Relevant,Animation,1,2
325,R_2Et4m3dcEfqiJNm,27.15,1,3,3,7,6.666666667,7.75,6.333333333,3,0,1,4,11,15,2,1,0,3,3,6,Immediate,Irrelevant,Animation,1,1
326,R_qClTa1pl2LlPBZL,16.4,0,3,7,10,5.333333333,7.5,7.333333333,1,0,0,1,9,10,2,0,1,3,1,4,Immediate,Relevant,Static,1,1
327,R_YSOmTI3uAxK9Vx7,20.91666667,0,1,6,7,5.333333333,5.25,3,4,5,3,12,12,24,2,1,1,4,1,5,Delayed,Irrelevant,Static,1,1
328,R_3JCanhOhV8bF9Eu,21.93333333,0,2,11,13,4.666666667,9,6,4,3,0,7,8,15,2,1,0,3,3,6,Delayed,Irrelevant,Animation,1,1
329,R_D8dLiL8CglB5V3X,23.16666667,0,2,9,11,4,7.25,5.666666667,3,1,0,4,6,10,1,1,0,2,1,3,Delayed,Irrelevant,Static,1,2
330,R_3k0vHJddTbP5gGg,23,0,2,3,5,3.666666667,3.75,7.666666667,1,1,1,3,8,11,1,1,0,2,1,3,Delayed,Relevant,Static,1,2
331,R_2zj4wiuY78zgF9X,24.06666667,0,3,10,13,4,6.25,6.333333333,3,0,1,4,11,15,1,1,0,2,3,5,Immediate,Relevant,Animation,1,2
332,R_2qxz28hgblrOch8,20.83333333,1,1,0,2,1,4.75,4.333333333,3,2,0,5,13,18,1,0,0,1,3,4,Immediate,Relevant,Static,1,1
333,R_2QoE4bPJbF8lZmZ,21.55,2,1,3,6,3,8.25,7.333333333,3,0,2,5,12,17,1,1,0,2,3,5,Immediate,Irrelevant,Animation,1,2
334,R_21aYXCVvpOGnWNC,24.38333333,0,1,4,5,7,7.75,2.333333333,2,1,0,3,8,11,1,1,0,2,1,3,Delayed,Irrelevant,Static,1,1
335,R_2B8rDJvLGzw8YHC,28.91666667,0,1,0,1,7.666666667,8.75,5.333333333,2,0,0,2,12,14,1,0,0,1,2,3,Immediate,Relevant,Animation,1,1
336,R_3synNj8zqhBYzwi,26.13333333,0,2,5,7,6,5.5,4.666666667,3,1,0,4,12,16,1,1,0,2,2,4,Delayed,Relevant,Animation,1,1
337,R_22wX4RirPuoxTYp,27.65,2,3,4,9,4,7,5.666666667,2,0,2,4,9,13,0,1,2,3,2,5,Immediate,Irrelevant,Animation,1,1
338,R_O9Uh9jDZUCkO5Vf,28.83333333,0,3,8,11,3.666666667,7.25,7.333333333,4,4,2,10,14,24,0,1,0,1,2,3,Immediate,Irrelevant,Static,1,1
339,R_1rph2wty4rTCGHw,20.36666667,0,2,6,8,2.333333333,9.5,8.333333333,2,4,2,8,13,21,0,1,0,1,1,2,Delayed,Relevant,Static,1,1
340,R_1Ora8tJ1xsY7lhX,19.8,0,1,4,5,3.333333333,5.75,6,2,2,1,5,10,15,0,1,0,1,1,2,Delayed,Relevant,Animation,1,1
341,R_2R37yIFgEdHYsrW,25.8,0,1,9,10,4.333333333,7.25,3.333333333,1,0,0,1,7,8,1,0,0,1,3,4,Immediate,Irrelevant,Static,2,2
342,R_325ty16YZTfAZKw,23.68333333,1,2,2,5,5.333333333,10,7.666666667,3,1,1,5,11,16,1,1,1,3,3,6,Delayed,Relevant,Static,1,1
343,R_2PqlMuHlDGB37qY,32.45,0,1,4,5,6.333333333,5.5,8.666666667,2,1,3,6,6,12,1,1,0,2,2,4,Immediate,Irrelevant,Animation,1,2
344,R_3EbWPQ0CkUXmx7O,13.73333333,0,2,4,6,6,6.5,6,2,0,0,2,5,7,0,1,0,1,0,1,Immediate,Irrelevant,Static,1,1
345,R_2Y9Wik4twxguGI3,17.15,0,1,2,3,4.333333333,3.75,2,1,1,3,5,8,13,1,1,0,2,2,4,Delayed,Irrelevant,Animation,1,1
346,R_1EXrV6hKikIIlfH,22.08333333,0,1,12,13,4.333333333,7.5,6.333333333,4,1,2,7,13,20,1,0,0,1,1,2,Immediate,Relevant,Static,1,1
347,R_32KKc9gfvsIuxTQ,25.16666667,2,3,12,17,5.333333333,7.25,5.666666667,4,4,0,8,11,19,1,1,1,3,1,4,Delayed,Relevant,Animation,1,1
348,R_2ZDB6WU2NRCsD92,25.6,0,2,2,4,3,5,3.333333333,0,0,1,1,6,7,0,1,0,1,1,2,Delayed,Irrelevant,Static,1,2
349,R_2zeYcD3Kx0Knnrq,25.78333333,0,2,0,2,6.333333333,7,5.333333333,2,0,2,4,3,7,0,0,0,0,0,0,Immediate,Relevant,Animation,1,1
350,R_2zTG7Xj6j9qkCMJ,14.18333333,0,1,2,3,4.666666667,8.75,4,2,0,0,2,9,11,1,1,1,3,1,4,Delayed,Irrelevant,Animation,1,1
351,R_27j24qwODka68BC,17.7,0,2,3,5,2,8.75,9,1,0,0,1,5,6,0,0,0,0,0,0,Immediate,Relevant,Static,1,1
352,R_2fwV48KKGjSEw2R,22.63333333,0,3,7,10,5.666666667,7.5,6.666666667,2,0,0,2,6,8,2,1,1,4,2,6,Immediate,Relevant,Static,1,1
353,R_e2LdEBmXoErT77r,19.38333333,0,2,7,9,5,5,4.333333333,3,2,0,5,5,10,1,0,1,2,1,3,Delayed,Irrelevant,Animation,1,1
354,R_3hygiSwJHTEpJSS,52.28333333,2,3,5,10,3.333333333,6,6.333333333,0,0,0,0,7,7,0,1,0,1,1,2,Immediate,Relevant,Animation,1,2
355,R_1pSebVWMkmiMt44,21.71666667,3,3,16,22,8.333333333,9,4.666666667,4,9,2,15,13,28,1,2,1,4,3,7,Immediate,Relevant,Animation,1,1
356,R_2WvDkcnoz8m1YFU,35.25,1,1,0,2,7,9,6,1,1,0,2,6,8,0,1,0,1,1,2,Delayed,Irrelevant,Static,1,2
357,R_2zD2SSTm1RjHJ82,28.61666667,0,1,3,4,4.333333333,7.75,5,2,0,3,5,9,14,0,1,0,1,1,2,Delayed,Relevant,Static,1,2
358,R_umfYFp44PZr7TEZ,30.2,3,1,7,11,4,5.5,6,2,1,2,5,13,18,2,0,1,3,2,5,Delayed,Irrelevant,Static,1,2
359,R_1rctBGGzyMZteVU,20.3,0,1,3,4,6,9.5,8,4,1,2,7,11,18,2,0,1,3,2,5,Immediate,Irrelevant,Animation,1,1
360,R_2zBXyopQwJFYGf6,22.8,2,4,12,18,4.333333333,6.75,4,4,0,1,5,5,10,1,1,0,2,2,4,Delayed,Relevant,Static,1,2
361,R_1dyI422KSdsyQtz,30.95,3,5,8,16,4.666666667,8.75,7,5,8,2,15,10,25,2,2,0,4,3,7,Immediate,Relevant,Animation,1,1
362,R_3MT3dM6uguGN9dF,32.38333333,1,2,7,10,4,2.25,2,4,1,0,5,11,16,1,1,0,2,2,4,Delayed,Irrelevant,Static,1,1
363,R_SBiJHIPZvObRkcx,14.95,0,2,0,2,2.333333333,5.25,4.666666667,1,0,0,1,8,9,1,0,0,1,3,4,Immediate,Irrelevant,Animation,1,1
364,R_2rDvJggYsdJJcQP,21.4,1,1,7,9,2.666666667,8.75,9.333333333,3,3,2,8,10,18,1,1,0,2,2,4,Immediate,Irrelevant,Animation,1,1
365,R_3WpjyDwGIoQ7pJf,23.36666667,0,3,6,9,6.333333333,5.75,7.333333333,2,2,1,5,11,16,2,2,0,4,2,6,Delayed,Relevant,Static,1,1
366,R_z6V5ICb1sLEKZQB,24.78333333,1,1,4,6,4.333333333,7.25,4.333333333,4,3,2,9,11,20,2,1,1,4,2,6,Delayed,Relevant,Animation,1,1
367,R_QgMOL8CkKt44dOh,18.18333333,0,3,1,4,6,6.5,3.333333333,1,0,0,1,5,6,0,1,0,1,2,3,Immediate,Relevant,Static,1,2
368,R_1qWGouvDDGGve4k,24.88333333,1,3,11,15,5.666666667,8,6,3,0,2,5,12,17,2,1,0,3,2,5,Delayed,Irrelevant,Animation,1,2
369,R_3QLykoAVVNGx8wD,25.88333333,0,2,7,9,7,7,6.666666667,3,0,0,3,10,13,1,1,1,3,1,4,Immediate,Irrelevant,Static,1,2
370,R_2Bgti22KRLaf8WU,33.76666667,2,3,6,11,5,4,2.333333333,4,0,1,5,11,16,1,1,0,2,1,3,Immediate,Relevant,Animation,1,1
371,R_7TFeGtwQyQ4yBzz,19.5,2,4,16,22,10,7.5,1.333333333,2,0,1,3,7,10,1,0,1,2,2,4,Delayed,Irrelevant,Static,1,2
372,R_1CEJI73aNNnhhLl,23.51666667,0,4,8,12,2,1.5,3.666666667,3,0,0,3,12,15,2,1,1,4,2,6,Delayed,Irrelevant,Animation,1,1
373,R_tSP9Wx8RoVZ14pr,30.25,1,4,9,14,6,5,1,2,1,1,4,9,13,1,0,0,1,2,3,Immediate,Relevant,Animation,1,1
374,R_25uQ8tURltuefgv,30.33333333,0,1,4,5,4,5.75,6,3,2,0,5,10,15,1,1,0,2,2,4,Delayed,Irrelevant,Static,1,2
375,R_3oRE3z28gkJNk1r,25.18333333,0,4,9,13,3.333333333,9,7.666666667,3,0,2,5,9,14,1,0,0,1,2,3,Delayed,Irrelevant,Static,1,2
376,R_Ze0SzztwLodBTcR,26.51666667,2,2,5,9,2.666666667,5.5,7.666666667,3,1,2,6,9,15,2,1,0,3,2,5,Immediate,Irrelevant,Animation,1,2
377,R_2dhaEsYAtQUOVlh,27.46666667,0,1,0,1,3.666666667,7,4,1,0,1,2,3,5,2,0,0,2,1,3,Immediate,Relevant,Static,1,1
378,R_5bct5cbwJ98Cx5T,28.01666667,0,1,0,1,2.666666667,2.25,2.333333333,2,0,0,2,4,6,0,0,0,0,1,1,Immediate,Relevant,Static,1,2
379,R_BXixywmA4MZAn1n,16.88333333,0,1,9,10,6.333333333,8.75,2,2,0,0,2,5,7,1,1,0,2,2,4,Immediate,Relevant,Static,1,2
380,R_1riwppujQejB7rj,19.01666667,1,1,3,5,3.666666667,7.5,7.333333333,2,0,2,4,10,14,1,1,1,3,1,4,Immediate,Relevant,Static,1,1
381,R_2Euirf00gIDRKB7,21.3,0,1,5,6,5,7,6.333333333,3,1,0,4,11,15,2,1,1,4,2,6,Delayed,Irrelevant,Animation,1,1
382,R_3m38cxtHR7L3BRK,17.76666667,0,1,3,4,9,8.75,3.666666667,1,0,0,1,6,7,1,1,0,2,1,3,Delayed,Relevant,Animation,1,1
383,R_29hMTD4gYQ6Y0wA,15.61666667,0,2,4,6,2.666666667,6.25,7.666666667,2,1,0,3,6,9,1,0,1,2,1,3,Delayed,Irrelevant,Static,1,2
384,R_3JsciBJEgp0zYhe,22.81666667,2,2,10,14,5.333333333,8.75,9.666666667,6,7,1,14,12,26,1,1,1,3,2,5,Immediate,Relevant,Animation,1,2
385,R_2ckLbnCCF3G4CYP,23.46666667,0,3,10,13,4.333333333,5.75,3.333333333,2,0,0,2,4,6,0,1,1,2,1,3,Immediate,Irrelevant,Static,1,1
386,R_2uxquyCWnFh8Y5J,20.08333333,0,2,2,4,4.333333333,5.5,5,1,0,0,1,5,6,1,2,1,4,3,7,Delayed,Irrelevant,Static,1,2
387,R_3FRS6WZUFMHTdGa,28.48333333,0,3,8,11,3,8,5.666666667,3,0,0,3,5,8,1,1,1,3,1,4,Immediate,Relevant,Animation,1,1
388,R_29tdTrr9iPRUqPA,36.05,1,1,4,6,3.333333333,4.75,2.333333333,1,0,2,3,4,7,2,1,0,3,2,5,Delayed,Irrelevant,Animation,1,2
389,R_3NOgY8i3mgRgHCY,35.5,0,1,5,6,4.666666667,6.25,4,4,1,1,6,10,16,0,1,1,2,0,2,Delayed,Relevant,Static,1,1
390,R_2z6KLA2bTwQw9tG,20.18333333,0,1,2,3,2.333333333,3.25,5.333333333,4,0,0,4,7,11,1,1,0,2,2,4,Immediate,Relevant,Static,1,1
391,R_2UhDVUhQU43gaH1,20.28333333,0,1,1,2,6.333333333,7.75,6.666666667,0,2,0,2,8,10,1,1,0,2,3,5,Immediate,Irrelevant,Animation,1,1
392,R_3kgMve5yfVGMXsu,20.5,0,1,0,1,2,6,1.666666667,1,0,0,1,3,4,0,1,0,1,1,2,Delayed,Irrelevant,Static,1,2
393,R_3HNO9fWBBrfPPgB,24.65,0,1,1,2,4,6.25,6.666666667,2,2,0,4,9,13,0,0,1,1,2,3,Immediate,Relevant,Animation,1,1
394,R_2whN7qZHCatGvYJ,25.23333333,0,1,5,6,7,9.25,6.666666667,3,2,3,8,14,22,2,1,1,4,3,7,Delayed,Irrelevant,Animation,1,1
395,R_2Pb1LV0lSoVv9UB,26.75,0,1,0,1,5.666666667,6.75,2,2,0,0,2,7,9,1,1,0,2,3,5,Delayed,Irrelevant,Animation,1,1
396,R_2v1U4uVNdU0plSW,46.48333333,0,1,11,12,8.333333333,9,6,3,0,0,3,7,10,2,1,1,4,1,5,Immediate,Irrelevant,Static,1,1
397,R_27gqSLc9FW7fklU,24.96666667,0,1,4,5,6.333333333,9.25,5.666666667,2,0,0,2,8,10,0,0,0,0,0,0,Immediate,Relevant,Animation,1,1
398,R_PTdLm6S9GgX4BWN,26.16666667,0,1,6,7,4.666666667,5.5,1.333333333,2,0,0,2,5,7,1,1,0,2,1,3,Immediate,Relevant,Animation,1,2
399,R_1jlzVCnXkgMg5op,29.5,1,2,4,7,1,1,2,2,0,1,3,7,10,1,1,0,2,2,4,Delayed,Relevant,Static,1,2
400,R_3ize2QsUHs8XR3A,16.2,0,2,0,2,4.666666667,4.5,6,0,0,0,0,11,11,2,1,0,3,2,5,Immediate,Irrelevant,Static,1,1
401,R_2390IAkoHnYa1JD,17.21666667,1,2,10,13,7.666666667,8.25,6.333333333,2,0,1,3,9,12,1,1,0,2,2,4,Delayed,Irrelevant,Animation,1,1
402,R_UEhZkHcFbGOeaTT,24.91666667,3,4,14,21,4,8.5,4.666666667,2,6,0,8,12,20,1,1,1,3,3,6,Delayed,Irrelevant,Static,1,1
403,R_yDXlBwiwCxj4ijf,32.28333333,0,1,1,2,3,7.5,8,2,0,0,2,9,11,0,1,1,2,1,3,Delayed,Relevant,Static,1,1
404,R_2awB4aRIFMJV1VB,16.03333333,0,5,11,16,5,9,8.333333333,2,0,0,2,10,12,1,0,0,1,2,3,Immediate,Irrelevant,Animation,1,2
405,R_ULbaq9WaP3chjLr,20.31666667,0,1,1,2,8.666666667,8.75,8,1,0,0,1,6,7,1,0,0,1,1,2,Immediate,Relevant,Animation,1,2
406,R_1pQlmc78jFWhUFR,18.96666667,0,3,4,7,1,6.5,10,1,2,1,4,8,12,1,1,0,2,1,3,Delayed,Relevant,Static,1,1
407,R_2ceDyflbd3GlBCe,17.31666667,1,1,11,13,3.333333333,7.5,7,1,0,1,2,10,12,0,1,1,2,1,3,Immediate,Relevant,Static,1,1
408,R_3qPbkrIerlWCZ31,17.73333333,1,2,3,6,4,5.25,7.333333333,1,0,0,1,10,11,1,1,0,2,2,4,Delayed,Irrelevant,Static,1,2
409,R_2AKJ9bHROHLDYH9,19.46666667,2,2,4,8,2.666666667,4.5,8,5,1,2,8,13,21,0,2,1,3,3,6,Delayed,Relevant,Animation,1,2
410,R_2YlIpZUY7mX4CUs,16.06666667,0,1,4,5,6,8,6.666666667,4,0,1,5,10,15,1,0,0,1,3,4,Immediate,Irrelevant,Animation,1,1
411,R_2a9zVOSDKv44tDh,17.05,0,1,5,6,3,8.5,6,1,0,0,1,9,10,1,0,1,2,0,2,Immediate,Irrelevant,Animation,1,1
412,R_2zHGyvhYnPwktVR,27.11666667,0,1,0,1,5,8.5,8.333333333,3,3,2,8,12,20,2,0,0,2,2,4,Delayed,Relevant,Animation,1,1
413,R_1LUoJWBKJnUGidw,15.73333333,0,4,6,10,1,7,7,3,0,0,3,7,10,0,1,0,1,2,3,Delayed,Irrelevant,Static,1,1
414,R_vx0gOsFRAFlJQSR,20.4,0,1,9,10,4.333333333,9,6,4,0,1,5,11,16,2,1,1,4,3,7,Delayed,Relevant,Animation,1,1
415,R_ONKGtz0lnpF1p1n,20.53333333,0,1,1,2,3.666666667,1.25,0,1,0,0,1,7,8,1,1,1,3,2,5,Immediate,Relevant,Static,1,1
416,R_3G7WUKEfQEVrXsW,28.66666667,0,2,1,3,6.666666667,6.5,8.666666667,5,0,0,5,8,13,0,1,1,2,3,5,Immediate,Relevant,Static,1,1